0000000000000000000000000000000000000000000000000000000000000000000000000000000000000000000000000000000000000000000000000000000000000000000000000000000000000000000000000000000000000000000000000000000000000000000000000000000
0000000000000000000000000000000000000000000000000000000000000000000000000000000000000000000000000000000000000000000000000000000000000000000000000000000000000000000000000000000000000000000000000000000000000000000000000000000
0000000000000000000000000000000000000000000000000000000000000000000000000000000000000000000000000000000000000000000000000000000000000000000000000000000000000000000000000000000000000000000000000000000000000000000000000000000
0000000000000000000000000000000000000000000000000000000000000000000000000000000000000000000000000000000000000000000000000000000000000000000000000000000000000000000000000000000000000000000000000000000000000000000000000000000
00000000000000000000000000000000000000000000000000000000000000000000000000000000B0B00000000000000000000000000000000000000000000000000000000000000000000000000000000000000000000000000000000000000000000000000000000000000000000
0000000000000000000000400000000000000000000000000000000000000000000000000000000033333333000333400000000000000500000000000333000034430000000000000000000000000000000000000000000000000000000011000000000000000000000000000000000
0000000000000000000000000000000000000000000000000000000000000000000000000000000000000000000000000000000000000000000000000000000000000000000000000000000000000000000000000000000000000000000111000000000000000000000000000000000
0000000000000000000000000000000000000000000000000000000000000000000000000000000000000000000000000000000000000000000000000000000000000000000000000000000000000000000000000000000000000000001111000000000000000000000000000000000
0000000000000000000000000000000000000000000000000000000000000000000000000000000000000000000000000000000000000000000000000000000000000000000000000000000000000000000000000000000000000000011111000000000000000000000000000000000
0000000000000000400035343000000000000000000000770000000007700000000000000000035300000000000000F00000300000400400400000300000000003300000010010000000000110010000000000003343000000000000111111000000000000000000000000000000000
0000000000000000000000000000000000000077000000770000000007700000000000000000000000000000000000000000000000000000000000000000000000000000110011000000001110011000000000000000000000000001111111000000000000000000000000000000000
0000000000000000000000000000770000000077000000770000000007700000000000000000000000000000000000000000000000000000000000000000000000000001110011100000011110011100000770000000000000077011111111000000000000000000000000000000000
00z0000000000000000000B00000770000000077B0000077000B0B0007700000000000000000000000000000000000000B0B0000000C000000B0B0000000B0B0B0B0001111001111000011111001111000077000000000B0B0077111111111000000000000000000000000000000000
1111111111111111111111111111111111111111111111111111111111111111111110011111111111111100011111111111111111111111111111111111111111111111111111111111111110011111111111111111111111111111111111111111111111111111111111111111111
1111111111111111111111111111111111111111111111111111111111111111111110011111111111111100011111111111111111111111111111111111111111111111111111111111111110011111111111111111111111111111111111111111111111111111111111111111111