110z0000000000001111
11000000000000001111
11000000000000001111
11000000000000001111
11000000000000001111
11000000000000001111
11000000000000001111
110000uuuuu000001111
11000uuuuuuu00001111
11000uuuuuuu00001111
11000111111100001111
11000111111100911111
11000111111100911111
11111111111111111111
11111111111111111111
[[Portals]]
13,14,12,13,right,0101,164,10