110z0000000000001111
11000000000000001111
11000000000000001111
11000000000000001111
11000000000000001111
11000000000000001111
11000000000000001111
11000000000000001111
11000000000000001111
11000000000000001111
11000111111100001111
11000111111100111111
11000111111100111111
11111111111111111111
11111111111111111111